##############################
#S                          H#
########### ############ #####
#    #   ## #            #  F#
# ##   #    ##############  ##
# ###########      #######  ##
#              H#           H#
##############################