###   ###   ###   ###   ###   ###   ###   ###   ###   ###
##############################################################
#S                                                          F#
##############################################################
   ###   ###   ###   ###   ###   ###   ###   ###   ###   ###