#####################################
#S                                  #
################################### #
#                                 # #
# ############################### # #
# #                             # # #
# # ########################### # # #
# # #                         # # # #
# # # ####################### # # # #
# # # #                     # # # # #
# # # # ################### # # # # #
# # # # #                 # # # # # #
# # # # # ############### # # # # # #
# # # # # #             # # # # # # #
# # # # # # ########### # # # # # # #
# # # # # # #         # # # # # # # #
# # # # # # # ####### # # # # # # # #
# # # # # # # #    F# # # # # # # # #
# # # # # # # # ##### # # # # # # # #
# # # # # # # #       # # # # # # # #
# # # # # # # ######### # # # # # # #
# # # # # # #           # # # # # # #
# # # # # # ############# # # # # # #
# # # # # #               # # # # # #
# # # # # ################# # # # # #
# # # # #                   # # # # #
# # # # ##################### # # # #
# # # #                       # # # #
# # # ######################### # # #
# # #                           # # #
# # ############################# # #
# #                               # #
# ################################# #
#                                   #
#####################################